NO ./textures/wall_north.xpm
SO ./textures/wall_south.xpm
WE ./textures/wall_west.xpm
EA ./textures/wall_est.xpm

C 50,25,00
F 255,00,00

1111
11111111111111111111111
10000010000000000000001
10000000N00000000000001
11111110000111111111001
10000000000000000000001
10000010000000000000001
10000010000111111111001
11111110000000000000001
10000000000000000000001
10000010100111111111001
11111110000000000000001
      10000000000000001
      10000111111111001
      10000000000000001
      10000000000000001
      10000111111111001
      10000000000000001
      10000000000000001
      10000111111111001
      10000000000000001
      10000000000000001
      10000111111111001
      10000000000000001
      10000000000000001
      11111111111111111