NO ./textures/wall_north.xpm
SO ./textures/wall_south.xpm
WE ./textures/wall_west.xpm
EA ./textures/wall_est.xpm

C 50,25,00
F 255,00,00

        1111111111111111111111111
        1000000000110000000000001
        100000000011000000N000001
        1011000001110000000000001
        1001000000000000000000001
111111111011000001110000000000001
100000000011000001110111100011111
11110111111111011100000010001
11110111111111011101010010001
10000001101010111000000000001
10000000000000001100000010001
10100000000000001100000010001
100000000000000011010100100011111
110000011101010111110111100000001
111101111 110101 1 1111 100011101
11111111 1111111 111111111111 111